000000001000000
011110111111111
010100101000000
001111101000000
000101001000000
000100001000000
011111101000000
010100000000000
010111111000000
110100010000000
000100010000000
000100010000000
000100010000000
000100010000000
000100010000000
