333333113355555
311133113355555
314143113355555
344443333355555
334433233355555
355553211355511
355553223355555
355553323133333
322222223122333
322222223122333
333333333111333
333233333111222
222222223332133
222222223332222
222222333332222
