555222222555255
555555222222255
555335252444222
553333252224222
555332222224444
555111222224444
535215522444433
535225512444333
532222111445333
335522224443333
335222225553333
555552245533333
555555244433333
555555244433333