111111112111111
122221222222222
121211212111111
112222212111111
111212112111111
111211112111111
122222212111111
121211111111111
121222222111111
221211121111111
111211121111111
111211121111111
111211121111111
111211121111111
111211121111111
