212022212022
144412144412
244412244412
044412044412
211112211112
000000000000
000000212022
144412144412
211112244412
044412044412
211112211112
000000000000