000111111000100
000000111111100
000220101333111
002222101113111
000221111113333
000444111113333
020140011333322
020110041333222
021111444330222
220011113332222
220111110002222
000001130022222
000000133322222
000000133322222